A-frame (construction)	khung chữ A (kết cấu)
Abutment	tường chống, chân vòm; mố cầu
Acceberated weathering	sự phong hóa tăng nhanh
Acceleration 	Đẩy nhanh tiến độ
Accelerator, Earlystrength admixture	Phụ gia tăng nhanh hóa cứng bê tông
Acess to the site 	ra vào công trường
Action	tác động, tác dụng; sự hoạt động
Action effect	hiệu quả hoạt động
Activity schedule 	Biểu khối lượng công việc
Adjustable prop	[cột, thanh chống] điều chỉnh được
Advance payment 	Tạm ứng
After anchoring	Sau khi neo xong cốt thép dự ứng lực
Air supported structure	kết cấu đỡ bằng khí cầu
Alloy(ed) steel	Thép hợp kim
Anchor	cái neo
Anchor bolt	bulông neo
Anchor plate	bản neo
Anchor sliding	Độ trượt trong mấu neo của đầu cốt thép
Anchorage length	Chiều dài đoạn neo giữ của cốt thép
Approval of the Contractor's temporary works	Phê duyệt các công trình tạm của Nhà thầu
Arch	cuốn, vòm; cửa cuốn
Arch bridge	cầu vòm
Area of reinforcement	Diện tích cốt thép
Arrangement of longitudinales renforcement cut-out	Bố trí các điểm cắt đứt cốt thép dọc của dầm
Arrangement of reinforcement	Bố trí cốt thép
Atmospheric corrosion resistant steel	Thép chống rỉ do khí quyển
Attached pier	cột chống; cột giả
Back-shore	[thanh, cọc] chống xiên
Backpropping	sự chống xiên; thanh chống xiên
Bag	Bao tải (để dưỡng hộ bê tông)
Bag of cement 	Bao xi măng
Balloon-frame construction	kết cấu khung nhà gỗ nhẹ
Bar (reinforcing bar)	Thanh cốt thép
Base	nền; móng; bệ
Base structure	kết cấu nền móng
Baseplate		tấm đệm, tấm lót
Batter	sườn dốc, mái dốc; độ nghiêng mặt ngoài
Beam of constant depth	Dầm có chiều cao không đổi
Beam reinforced in tension and compression	Dầm có cả cốt thép chịu kéo và chịu nén
Beam reinforced in tension only	Dầm chỉ có cốt thép chịu kéo
Bedding	Móng cống
Before anchoring	Trước khi neo cốt thép dự ứng lực
Bending strength 	Độ bền uốn
Bent-up bar	Cốt thép uốn nghiêng lên
Bonded tendon	Cốt thép dự ứng lực có dính bám với bê tông
Bonded tendon	Cốt thép dự ứng lực có dính bám với bê tông
Bored pile	Cọc khoan nhồi
Bottom lateral	Thanh giằng chéo ở mọc hạ của dàn
Bottom reinforcement	Cốt thép bên dưới (của mặt cắt)
Braced member	Thanh giằng ngang
Bracing	Giằng gió
Breaking strength 	Giới hạn bền, sức chống phá huỷ
Brinell hardness test	sự thử độ cứng Brinell 
Broad flange beam 	dầm có cánh bản rộng (Dầm I, T) 
Buckling strength 	Cường độ uốn dọc
Builder's hoist 	Máy nâng dùng trong xây dựng
Bursting concrete stress	ứng suất vỡ tung của bê tông
Cable disposition	Bố trí cốt thép dự ứng lực
Carbon steel	Thép các bon (thép than)
Cast in many stage phrases	Đổ bê tông theo nhiều giai đoạn
Cast in place	Đúc bê tông tại chỗ
Cast in situ place concrete	Bê tông đúc tại chỗ
Cast in situ structure (slab, beam, column)	Kết cấu đúc bê tông tại chỗ (dầm, bản, cột)
Cast steel	Thép đúc
Cast,(casting)	Đổ bê tông (sự đổ bê tông)
Cast-in-place bored pile	Cọc khoan nhồi đúc tại chỗ
Cast-in-place concrete caisson	Giếng chìm bê tông đúc tại chỗ
Cast-in-place concrete pile	Cọc đúc bê tông tại chỗ
Cast-in-place, posttensioned bridge	Cầu dự ứng lực kéo sau đúc bê tông tại chỗ
Cast-in-situ flat place slab	Bản mặt cầu đúc bê tông tại chỗ
Castellated beam 	dầm thủng 
Casting schedule	Thời gian biểu của việc đổ bê tông
Catenary arch	cuốn có dạng xích treo
Caupling	Nối cốt thép dự ứng lực
Center spiral	Lõi hình xoắn ốc trong bó sợi thép
Changes in Activity Schedule 	Thay đổi lịch tiến độ
Characteristic strength 	Độ bền đặc trưng
Checking concrete quality	Kiểm tra chất lượng bê tông
Chillid steel	Thép đã tôi
Closure joint	Mối nối hợp long (đoạn hợp long)
Coating	Vật liệu phủ để bảo vệ cốt thép DưL khỏi rỉ hoặc giảm ma sát khi căng 
Communications 	Các biện pháp thông tin liên lạc
Compensation events 	Các trường hợp bồi thường
Completion date 	Ngày hoàn thành
Completion of contract 	Hoàn thành hợp đồng
Composite steel and concrete structure	Kết cấu liên hợp thép – bê tông cốt thép
Composite steel and concrete structure	Kết cấu liên hợp thép – bê tông cốt thép
Compremed concrete zone	Vùng bê tông chịu nén
Compression reinforcement	Cốt thép chịu nén
Compressive strength 	Ứng suất chịu nén
Concrete	Bê tông
Concrete age at prestressing time	Tuổi của bê tông lúc tạo dự ứng lực
Concrete aggregate (sand and gravel) 	cốt liệu bê tông (cát và sỏi)
Concrete composition	Thành phần bê tông
Concrete cover	Bê tông bảo hộ (bên ngoài cốt thép)
Concrete hinge	Chốt bê tông
Concrete proportioning	Công thức pha trộn bê tông
Concrete stress at tendon level	ứng suất bê tông ở thớ đặt cáp dự ứng lực
Concrete surface treatement	Xử lý bề mặt bê tông
Concrete test hammer	Súng bật nảy để thử cường độ bê tông
Concrete thermal treatement	Xử lý nhiệt cho bê tông
Concrete unit weight, density of concrete	Trọng lượng riêng bê tông
Concrete-filled pipe pile	Cọc ống thép nhồi bê tông lấp lòng
Condition of curing	Điều kiện dưỡng hộ bê tông
Connect by hinge	Nối khớp
Connection	Ghép nối
Connection strand by strand	Nối các đoạn cáp dự ứng lực Kéo sau
Connector	Neo (của dầm thép liên hợp bản BTCT)
Construction successive stage(s)	(Các) Giai đoạn thi công nối tiếp nhau
Contract data	Dữ liệu Hợp đồng
Contract price 	Giá Hợp đồng
Contractor to construct the Works 	Nhà thầu phải thi công Công trình
Contractor's risks 	Rủi ro của Nhà thầu
Corner connector	Neo kiểu thép góc
Correction of defects 	Sửa chữa sai sót
Corroded reinforcement	Cốt thép đã bị rỉ
Cost control 	Kiểm soát chi phí
Cost of repairs 	Chi phí sửa chữa
Coupler	Đầu nối để nối các cốt thép dự ứng lực
Coupler (coupling)	Mối nối cáp dự ứng lực Kéo sau
Coupleur	Bộ nối các đoạn cáp dự ứng lực kéo sau
Cover plate	Bản thép phủ (ở phần bản cánh dầm thép )
Cover-meter, Rebar locator	Máy đo lớp bê tông bảo hộ cốt thép
Cover-meter, Rebar locator	Máy đo lớp bê tông bảo hộ cốt thép
Cover-plate	Bản nối ốp, bản má
Creep strength 	Độ bền từ biến
Crushing machine	Máy nén mẫu thử bê tông
Crushing strength 	Độ bền nén vỡ
Cure to cure, curing	Dưỡng hộ bê tông mới đổ xong
Curing	Bảo dưỡng bê tông trong lúc hóa cứng
Curing temperature	Nhiệt độ dưỡng hộ bê tông
Currencies 	Các loại tiền tệ
Cutting machine	Máy cắt cốt thép
Cutting strength 	Ứng lực cắt
Cylinder, Test cylinder	Mẫu thử bê tông hình trụ
Dayworks	Công việc công nhật
Deck plate girder	Dầm bản thép có đường xe chạy trên
Deep foundation	Móng sâu
Defect notice period 	Thời gian thông báo về sai sót (tương đương với nghĩa là thời gian bảo hành)
Defects 	Sai sót (kỹ thuật)
Deformed bar, deformed reinforcement	Cốt thép có gờ (cốt thép gai)
Deformed reinforcement	Cốt thép có độ dính bám cao (có gờ)
Deformed reinforcement	Cốt thép có độ dính bám cao (có gờ)
Degign action effect	hiệu quả hoạt động thiết kế
Delegation 	Đại diện
Depth	Chiều cao
Depth of beam	Chiều cao dầm
Dile splicing	Nối dài cọc
Discoveries 	Những thứ phát hiện được (khi thi công)
Disputes	tranh chấp
Distribution reinforcement	Cốt thép phân bố
Dry guniting	Phun bê tông khô
Duct	ống chứa cốt thép dự ứng lực
During stressing operation	Trong quá trình Kéo căng cốt thép
Dynamic strength 	Độ bền động, độ bền va chạm
Early strength concrete	Bê tông hóa cứng nhanh
Early warning 	Cảnh báo trước
Effective depth at the section	Chiều cao có hiệu
Efflorescence	ố mầu trên bề mặt bê tông
Elastic strength 	Độ bền đàn hồi
Elastomatric bearing	Gối cao su
Elliptical arch	cuốn hình elip
Employer's risks	Rủi ro của Chủ đầu tư
English bond 	Xếp mạch kiểu Anh
English cross bond/Saint Andrew's cross bond 	cách xây chéo kiểu Anh
Epingle Pin	Cốt thép găm (để truyền lực cắt trượt như neo)
Equipment for the distribution of concrete	Thiết bị phân phối bê tông
Erection reinforcement	Cốt thép thi công
Exposed reinforcement	Cốt thép lộ ra ngoài
Extension of intended completion date 	Gia hạn ngày hoàn thành dự kiến
External prestressed concrete	Bê tông cốt thép dự ứng lực ngoài
Fatigue strength 	Giới hạn mỏi
Field connection	Mối nối ở hiện trường
Field connection use high strength bolt	Mối nối ở hiện trường bằng bu lông cường độ cao
Field connection use high strength bolt	Mối nối ở hiện trường bằng bu lông cường độ cao
Final account 	Quyết toán
First floor ( second floor nếu là tiếng Anh Mỹ ) 	Lầu một (tiếng Nam), tầng hai (tiếng Bắc)
Fix the ends of reinforcement	Giữ cố định đầu cốt thép
Fixation on the form	Giữ cho cố định vào ván khuôn
Flange reinforcement	Cốt thép bản cánh
Flat Pratt girder 	dầm flat phẳng
Flexible sheath	ống mềm (chứa cáp, thép DƯL)
Flexural strength 	Giới hạn bền uốn
Footing	Bệ móng
Forces on parapets	Lực lên lan can
Form	Ván khuôn
Form exterior face 	Bề mặt ván khuôn
Form removal	Dỡ ván khuôn
Form vibrator	Đầm cạnh (rung ván khuôn)
Fouilk, bouchon	Bê tông bịt đáy (của móng Cáp cọc, của giếng, của hố)
Foundation	Móng
Foundation beam	dầm móng
Foundation material	Vật liệu của móng
Foundation soil	Đất nền bên dưới móng
Fractural strength 	Sức cản đứt
Fresh concrete	Bê tông tươi (mới trộn xong)
Frictional strength 	Độ bền ma sát
General conditions of Contract 	Các điều kiện chung của Hợp đồng
Gluing of steel plate	Dán bản thép
Goodbye	tạm biệt
Grade	Cấp (của bê tông, của …)
Grade of concrete	Cấp của bê tông
Grade of reinforcement	Cấp của cốt thép
Ground anchor	neo (vào) đất 
Grouting	Phun vữa lấp lòng ống chứa cốt thép dự ứng lực
Gusset plate	Bản nút, bản tiết điểm
H- beam 	dầm chữ H 
HDPE sheath	Vỏ bọc polyetylen mật độ cao của cáp dự 
Hand rail	Lan can
Heavy weight concrete	Bê tông nặng
High strength concrete	Bê tông cường độ cao
High strength steel	Thép cường độ cao
High strength steel	Thép cường độ cao
High tech work technique	Công trình kỹ thuật cao
High-strength material	Vật liệu cường độ cao
Highest flood level	Mức nước lũ cao nhất
Hight density	ống bằng polyetylen mật độ cao
Hole	Lỗ thủng, lỗ khoan
Hook	Móc câu (ở đầu cốt thép)
Hoop reinforcement	Cốt thép đặt theo vòng tròn
Hot-bending test	sự thử uốn nóng 
Hot-load test	sự thử tải nhiệt (sự thử độ chịu nhiệt khi có tải) 
Hydraulic concrete	Bê tông thủy công
I- beam 	dầm chữ I 
I- girder 	dầm chữ I 
Identifying defects 	Phát hiện sai sót
Impact strength 	Lực chống va đập
In-situ concrete 	bê tông đổ tại chỗ
Inclined bar	Cốt thép nghiêng
Indemnities 	Bồi thường
Insurance	Bảo hiểm
Internal prestressed concrete	Bê tông cốt thép dự ứng lực trong
Internal prestressed concrete	Bê tông cốt thép dự ứng lực trong
Internal vibrator	Đầm trong (vùi vào hỗn hợp bê tông)
Interpretation 	Diễn giải
Jacking end	Điểm đầu cốt thép được kéo căng bằng kích
Jacking force	Lực kích (để Kéo căng cốt thép)
Laminated steel	Thép cán
Language and law 	Ngôn ngữ và luật (áp dụng cho hợp đồng) 
Lap	Mối nối chồng lên nhau của cốt thép
Lateral bracing	Hệ giằng liên kết của dàn
Lateral strength 	Độ bền chống lực ngang
Lean concrete (low grade concrete)	Bê tông nghèo
Letter of acceptance 	Thư chấp thuận
Leveling	Cao đạc
Levelling instrument	Máy cao đạc (máy thủy bình)
Levelling point	Điểm cần đo cao độ
Ligature, Tie	Dây thép buộc
Light weight concrete	Bê tông nhẹ
Limit strength 	Độ bền giới hạn
Liquidated damages	Bồi thuờng thiệt hại
Location of the concrete compressive resultant	Điểm đặt hợp lực nén bê tông
Longitudinal reinforcement	Cốt thép dọc
Loss due to concrete instant deformation due to non-simultaneous prestressing of several strands	Mất mát dự ứng suất do biến dạng tức thời của bê tông khi Kéo căng các cáp
Loss due to concrete shrinkage	Mất mát do co ngót bê tông
Lost due to relaxation of prestressing steel	Mất mát do từ biến bê tông
Lost due to relaxation of prestressing steel	Mất mát do tự chùng cốt thép dự ứng lực
Low alloy steel	Thép hợp kim thấp
Low relaxation steel	Thép có độ tự chùng rất thấp
Low-grade concrete resistance	Bê tông mác thấp
Lower reinforcement layer	Lớp cốt thép bên dưới
Main reinforcement parallel to traffic	Cốt thép chủ song song hướng xe chạy
Main reinforcement perpendicular to traffic	Cốt thép chủ vuông góc hướng xe chạy
Management meeting 	Họp quản lý, họp điều độ
Medium relaxation steel	Cốt thép có độ tự chùng bình thường
Member with minimum reinforcement	Cấu kiện có hàm lượng cốt thép tối thiểu
Metal shell	Vỏ thép
Method of concrete curing	Phương pháp dưỡng hộ bê tông
Mild steel 	Thép non (thép than thấp)
Mix proportion	Tỷ lệ pha trộn hỗn hợp bê tông
Modular ratio	Tỷ số của các mô dun đàn hồi thép-bê tông
Modular ratio	Tỷ số của các mô dun đàn hồi thép-bê tông
Modulus of Elasticity 	Môđun đàn hồi
Movable casting	Thiết bị di động đổ bê tông
Movable form, Travling form	Ván khuôn di động
Non-destructive test	sự thử không phá hủy (mẫu thử) 
Non-prestressed reinforcement	Cốt thép thường (không dự ứng lực)
Normal relaxation steel	Thép có độ tự chùng thông thường
Normal weight concrete, Ordinary structural concrete	Bê tông trọng lượng thông thường
Notice 	Thông báo
Of laminated steel	Bằng thép cán
On-load test	sự thử trên đường 
Other contractors 	Các nhà thầu khác
Over-reinforced concrete	Bê tông có quá nhiều cốt thép
Overall depth of member	Chiều cao toàn bộ của cấu kiện
Overlap	Nối chồng
Parapet	Thanh nằm ngang song song của rào chắn bảo vệ trên cầu (tay vịn lan can cầu)
Parobolic arch	cuốn parabôn
Partial prestressing 	Kéo căng cốt thép từng phần
Payment certificate 	Chứng nhận thanh toán
Payment upon termination 	Thanh toán khi chấm dứt hợp đồng
Perforated cylindrical anchor head	Đầu neo hình trụ có khoan lỗ
Perimeter of bar	Chu vi thanh cốt thép 
Personnel 	Nhân sự 
Pile bottom level	Cao độ chân cọc
Pile cross sectional area 	Tiết diện ngang cọc
Pile foundation	Móng cọc
Pile shoe	Phần bọc thép gia cố mũi cọc
Plain concrete, Unreinforced concrete	Bê tông không cốt thép
Plain round bar	Cốt thép tròn trơn
Plaster	Thạch cao
Plate	Thép bản
Plate bearing	Gối bản thép
Plywood	Gỗ dán (ván khuôn)
Porosity	Độ xốp rỗng (của bê tông)
Portland-cement, Portland concrete	Bê tông ximăng
Possession of the site 	Sở hữu công trường
Posttensioning (apres betonage)	Phương pháp Kéo căng sau khi đổ bê tông
Precast concrete	Bê tông đúc sẵn
Precast concrete pile	Cọc bê tông đúc sẵn
Precasting Yard	Xưởng đúc sẵn kết cấu bê tông
Prestressed concrete	Bê tông cốt thép dự ứng lực
Prestressed concrete pile	Cọc bê tông cốt thép dự ứng lực
Prestressing bed	Bệ kéo căng cốt thép dự ứng lực
Prestressing by stages	Kéo căng cốt thép theo từng giai đoạn
Prestressing steel	Thép dự ứng suất
Prestressing steel, cable	Cốt thép dự ứng lực
Prestressing teel strand	Cáp thép dự ứng lực
Prestressing time	Thời điểm Kéo căng cốt thép
Pretensioning (avant betonage)	Phương pháp Kéo căng trước khi đổ bê tông
Price adjustment 	Điều chỉnh giá
Programme	Lịch tiến độ
Property 	(Sở hữu) tài sản
Protection against corrosion	Bảo vệ cốt thép chống rỉ
Protective concrete cover	Lớp bê tông bảo hộ
Pull-out bond test	sự thử độ dính của bê tông với cốt thép bằng cách kéo cốt thép 
Pumping concrete	Bê tông bơm
Push-pull test	sự thử kéo-đẩy 
Put in the reinforcement case	Đặt vào trong khung cốt thép
Quality control 	Kiểm soát chất lượng
Railing	Lan can trên cầu
Railing load	Tải trọng lan can
Ratio of non- prestressing tension reinforcement	Tỷ lệ hàm lượng cốt thép thường trong mặt cắt
Ratio of prestressing steel	Tỷ lệ hàm lượng cốt thép dự ứng lực
Rebound number	Số bật nảy trên súng thử bê tông
Record drawings 	Bản vẽ hoàn công (như as-built drawings)
Reedle vibrator	Đầm dùi (để đầm bê tông)
Reinforced concrete	Bê tông cốt thép thường
Reinforced concrete beam	Dầm bê tông cốt thép
Reinforced concrete beam	Dầm bê tông cốt thép
Reinforcement group	Nhóm cốt thép
Removal of the concrete cover	Bóc lớp bê tông bảo hộ
Renforced concrete bridge	Cầu bê tông cột thép thường
Retarder	Phụ gia chậm hóa cứng bê tông
Retension (money)	Tiền giữ lại (ở mỗi kỳ thanh toán, thường để giữ bảo hành) 
Ribbed plate	Thép bản có gân
Rigid arch	vòm cứng; vòm không khớp
Round steel tube	ống thép hình tròn
Rubber bearing, neoprene bearing	Gối cao su
Rupture limit of the prestressed steel	Giới hạn phá hủy của cốt thép dự ứng lực
Rupture strength 	Giới hạn độ bền đứt
Safety 	An toàn
Sand concrete	Bê tông cát
Sandlight weight concrete	Bê tông nhẹ có cát
Securities	Các khoản bảo lãnh
Segregation	Phân tầng khi đổ bê tông
Semi-balloon-frame construction	kết cấu khung nhà gỗ nhẹ vừa
Shape steel	Thép hình
Shear carried by concrete	Lực cắt do phần bê tông chịu
Shear reinforcement	Cốt thép chịu cắt
Shearing strength 	Độ bền trượt
Sheet pile	Cọc ván, cọc ván thép
Sheet pile	Cọc ván, cọc ván thép
Single wine, Individual wire	Sợi đơn lẻ (cốt thép sợi)
Site investigation report 	Báo cáo khảo sát hiện trường
Skin reinforcement	Cốt thép phụ đặt gần sát bề mặt
Slab reinforced in both directions	Bản đặt cốt thép hai hướng
Slab reinforcement	Cốt thép bản mặt cầu
Sliding agent	Chất bôi trơn cốt thép dự ứng lực
Sliding form	Ván khuôn trượt
Slump	Độ sụt (hình nón) của bê tông
Spacing of prestressing steel	Khoảng cách giữa các cốt thép dự ứng lực
Spalled concrete	Bê tông đã bị tách lớp (bị bóc lớp)
Span/depth ratio	Tỷ lệ chiều dài nhịp trên chiều cao dầm
Spiral reinforced column	Cột có cốt thép xoắn ốc
Spiral reinforcement	Cốt thép xoắn ốc
Splice	Nối ghép, nối dài ra
Splice plat, scab	Bản nối phủ
Splicing method	Phương pháp nối cọc
Sprayed concrete, Shotcrete,	Bê tông phun
Start date 	Ngày khởi công
Steel H pile	Cọc thép hình H 
Steel elongation	Độ dãn dài của cốt thép
Steel percentage	Hàm lượng thép trong bê tông cốt thép
Steel percentage	Hàm lượng thép trong bê tông cốt thép
Steel pipe filled with	ống thép nhồi bê tông
Steel pipe filled with	ống thép nhồi bê tông
Steel pipe pile, tubular steel pile	Cọc ống thép
Steel stress at jacking end	ứng suất thép ở đầu kích Kéo căng
Steel with particular properties	Thép có tính chất đặc biệt
Stiffened angles	Neo bằng thép góc có sườn tăng cường
Stirrup,link,lateral tie	Cốt thép đai (dạng thanh)
Straight reinforcement	Cốt thép thẳng
Strenghening steel	Thép tăng cường
Strengthening reinforcement	Cốt thép tăng cường thêm
Stress at anchorages after seating	ứng suất cốt thép dự ứng lực ở sát neo sau khi tháo kích
Structural engineering	kết cấu
Structural steel	Thép kết cấu
Stud shear connector	Neo kiểu đinh (của dầm thép liên hợp bê tông)
Stud shear connector	Neo kiểu đinh (của dầm thép liên hợp bê tông)
Subcontracting 	Thầu phụ
Subcontractor 	Nhà thầu phụ
Successive	Nối tiếp nhau
Superelevation	Siêu cao
Suspension of Work	Tạm ngừng thi công
T- beam 	dầm chữ T 
T- girder 	dầm chữ T 
Taking over 	bàn giao
Tamping	Đầm bê tông cho chặt
Tax 	thuế
Temporary works	Các công trình tạm (của nhà thầu)
Tensile strength 	Giới hạn bền kéo
Tensile strength at days age	Cường độ chịu kéo của bê tông ở ngày
Tension reinforcement	Cốt thép chịu kéo
Tension zone in concrete	Khu vực chịu Kéo của bê tông
Tensioning (tensioning operation)	Công tác kéo căng cốt thép
Termination 	Ngừng, chấm dứt (hợp đồng)
Test cube, cube	Mẫu thử khối vuông bê tông
Tests 	Kiểm tra, thử nghiệm
The Works to be completed by the Intended Completion Date 	Công trình phải được hoàn thành vào Ngày hoàn thành dự kiến
Three-hinged arch	vòm ba khớp
Time control 	kiểm soát tiến độ
To extend reinforcement	Kéo dài cốt thép
Top lateral	Thanh giằng chéo ở mọc thượng của dàn
Top lateral strut	Thanh giằng ngang ở mọc thượng của dàn
Top reinforcement	Cốt thép bên trên (của mặt cắt)
Tosbou	Khoan
Total angular change of tendon profile from anchor to point X	Tổng các góc uốn nghiêng của cốt thép dự ứng lực ở Khoảng cách x kể từ mἯfont>
Total angular change of tendon profile from jaching end to point x	Tổng các góc uốn của đường trục cốt thép dự ứng lực từ đầu kích đến
Transverse reinforcement	Cốt thép ngang
Transverse strength 	Độ bền uốn ngang
Trussed arch	vòm giàn
Twist step of a cable	Bước xoắn của sợi thép trong bó xoắn
Two-hinged arch	vòm hai khớp
Ultimate bending strength 	Giới hạn bền uốn
Ultimate compressive strength 	Giới hạn bền nén
Ultimate strength 	Giới hạn bền
Un*****ed concrete section	Mặt cắt bê tông chưa bị nứt
Unbonded tendon	Cốt thép dự ứng lực không dính bám với bê tông
Unbonded tendon	Cốt thép dự ứng lực không dính bám với bê tông
Uncorrected defects 	Các sai sót không được sửa chữa
Unfilled tubular steel pile	Cọc ống thép không lấp lòng
Variations 	Các thay đổi ( Chủ đầu tư yêu cầu Nhà thầu thực hiện một công việc nào đó khác đi so với hợp đồng ban đầu)
Vertical clearance	Chiều cao tịnh không
Vertical-tie	Neo dạng thanh thẳng đứng để nối phần bê tông cốt thép khác nhau
Vertical-tie	Neo dạng thanh thẳng đứng để nối phần bê tông cốt thép khác nhau
Vertical-tie	Neo dạng thanh thẳng đứng để nối phần bê tông cốt thép khác nhau
Viaduct	Cầu có trụ cao
Vierendeel girder 	giàn Vierenddeel (giàn Bỉ)
Wall anchor	neo (vào) tường
Warren girder 	giàn biên //mạng tam giác
Weathering steel (need not be painted)	Thép chịu thời tiết (không cần sơn)
Web reinforcement	Cốt thép trong sườn dầm
Welded plate girder	Dầm bản thép hàn
Welded wire fabric, Welded wire mesh	Lưới cốt thép sợi hàn
Wet guniting	Phun bê tông ướt
Wind bracing	Giằng gió
Wind-tunnel test	sự thử bằng ống khí động học
Yeild point stress of prestressing steel	ứng suất đàn hồi của cốt thép dự ứng lực
Yield strength 	Giới hạn chảy, ứng suất chảy
Yield strength of rein forcement in compression	Cường độ đàn hồi của thép lúc nén
Yield strength of reinforcement in tension	Cường độ đàn hồi của thép lúc kéo
Z- beam 	dầm chữ Z
absorption test	sự thử lực hấp thu 
accelerated load test	sự thử chịu tải gia tăng 
accelerated test	sự thử gia tăng
acceleration test	sự thử nghiệm gia tốc 
acceptance test	sự thử nghiệm thu 
acid-resisting concrete 	bê tông chịu axit 
actual load 	tải trọng thực, tải trọng có ích 
actual test	sự thử nghiệm khai thác, sự thử nghiệm thực 
additional load 	tải trọng phụ thêm, tải trọng tăng thêm 
additive test	sự xác định hàm lượng chất phụ gia 
adhesion test	sự thử lực bám 
aerated concrete 	bê tông xốp/ tổ ong 
ageing test	sự thử lão hóa 
agglomerate-foam conc. 	bê tông bọt thiêu kết/bọt kết tụ
air test	sự thử độ kín; sự thử bằng không khí nén 
air-entrained concrete 	bê tông có phụ gia tạo bọt 
air-placed concrete 	bê tông phun 
allowable load 	tải trọng cho phép 
alloy steel	thép hợp kim
alternate load 	tải trọng đổi dấu 
alternate-stress test	sự thử ứng suất đổi đầu 
altitude test	sự thử nghiệm trên cao; sự thử nghiệm độ cao 
angle bar	thép góc
angle beam 	xà góc; thanh giằng góc 
angle brace/angle tie in the scaffold 	thanh giằng góc ở giàn giáo
angular test	sự thử kiểm tra, sự kiểm nghiệm ( 
antisymmetrical load 	tải trọng phản đối xứng 
apex load 	tải trọng ở nút (giàn)
arbitration test	sự thử nghiệm trọng tải (sự thử nghiệm để phân xử)
architectural concrete 	bê tông trang trí
armoured concrete 	bê tông cốt thép 
articulated girder 	dầm ghép 
asphaltic concrete 	bê tông atphan 
assumed load 	tải trọng giả định, tải trọng tính toán 
atrition test	sự thử mài mòn 
average load 	tải trọng trung bình 
axial load 	tải trọng hướng trục 
axle load 	tải trọng lên trục 
balance beam 	đòn cân; đòn thăng bằng 
balanced load 	tải trọng đối xứng 
balancing load 	tải trọng cân bằng 
ballast concrete 	bê tông đá dăm 
band-over test	sự thử bẻ cong 
basement of tamped (rammed) concrete 	móng (tầng ngầm) làm bằng cách đổ bê tông
basic load 	tải trọng cơ bản 
bearable load 	tải trọng cho phép 
bed load 	trầm tích đáy 
bend(ing) test	sự thử uốn 
bending load 	tải trọng uốn 
best load 	công suất khi hiệu suất lớn nhất (tuabin) 
bituminous concrete 	bê tông atphan 
blank test	sự thử bất kỳ, mẫu thử ngẫu nhiên 
blow test	sự thử sức chịu va đập; sự thử độ bền va đập 
blow-bending test	sự thử uốn va đập 
bond beam 	dầm nối 
boring test	sự thử bằng khoan
bow girder 	dầm cong 
bowstring girder 	giàn biên cong 
box beam 	dầm hình hộp 
box girder 	dầm hộp 
braced girder 	giàn có giằng tăng cứng 
bracing beam 	dầm tăng cứng 
bracket load 	tải trọng lên dầm chìa, tải trọng lên công xôn 
brake beam 	đòn hãm, cần hãm 
brake load 	tải trọng hãm 
break-down test	sự thử đứt; sự thử gãy 
breaking load 	tải trọng phá hủy 
breaking test	sự thử đứt; sự thử gãy 
breast beam 	tấm tì ngực; (đường sắt) thanh chống va, 
breeze concrete 	bê tông bụi than cốc 
brick 	Gạch
brick girder 	dầm gạch cốt thép 
brick wall 	Tường gạch
bricklayer /brickmason 	Thợ nề
bricklayer's hammer (brick hammer) 	búa thợ nề
bricklayer's labourer/builder's labourer 	Phụ nề, thợ phụ nề
bricklayer's tools 	Các dụng cụ của thợ nề
bridge beam 	dầm cầu 
bridge test	sự xác định bằng cầu điện trở 
brittleness test	sự thử độ giòn 
broken concrete 	bê tông dăm, bê tông vỡ 
buckling load 	tải trọng uốn dọc tới hạn, tải trọng mất ổn định dọc 
buffer beam 	thanh chống va, thanh giảm chấn (tàu hỏa) 
buiding site 	Công trường xây dựng
build-up girder 	dầm ghép 
building site latrine 	Nhà vệ sinh tại công trường xây dựng
built up section	thép hình tổ hợp
bump test	sự thử uốn 
bumper beam 	thanh chống va, thanh giảm chấn (tàu hỏa), dầm đệm 
bunched beam 	chùm nhóm 
buried concrete 	bê tông bị phủ đất 
bush-hammered concrete 	bê tông được đàn bằng búa
calibration test	sự thử định chuẩn 
calorimeter test	sự thử bằng nhiệt lượng kế; sự đo nhiệt lượng 
camber beam 	dầm cong, dầm vồng 
cantilever arched girder 	dầm vòm đỡ; giàn vòm công xôn 
cantilever beam 	dầm công xôn, dầm chìa 
capacitive load 	tải dung tính (điện) 
capping beam 	dầm mũ dọc 
carbon penetration test	sự thử độ thấm cacbon 
carbon test	sự thử hàm lượng cacbon 
carbonization test	sự thử cacbon hóa; sự thử tính oxi hóa 
carcase (cacass, farbric) [ house construction, carcassing]]	khung sườn (kết cấu nhà)
cased beam 	dầm thép bọc bê tông 
cast concrete 	bê tông đúc 
castelled section	thép hình bụng rỗng
cathode beam 	chùm tia catôt, chum tia điện tử 
cellar window (basement window)	các bậc cầu thang bên ngoài tầng hầm
cellular concrete 	bê tông tổ ong 
cellular girder 	dầm rỗng lòng 
cement 	Xi măng
cement concrete 	bê tông xi măng 
centre point load 	tải trọng tập trung 
centric load 	tải trọng chính tâm, tải trọng dọc trục 
centrifugal load 	tải trọng ly tâm 
centrifuge test	sự thử ly tâm; sự thử bằng máy ly tâm 
changing load 	tải trọng thay đổi 
channel section	thép hình chữ U
check test	sự thử kiểm tra 
chimney 	ống khói (lò sưởi)
chimney bond 	cách xây ống khói 
chopped beam 	tia đứt đoạn 
chuting concrete 	bê tông lỏng 
cinder concrete 	bê tông xỉ 
circulating load 	tải trọng tuần hoàn 
clarke beam 	dầm ghép bằng gỗ 
closure test	sự thử nén hết cỡ (lò xo)
cobble concrete 	bê tông cuội sỏi 
cold rolled steel	thép cán nguội
cold temperature test	sự thử ở nhiệt độ thấp 
cold test	sự thử lanh; sự thử ở nhiệt độ thấp 
cold weather test	sự thử trong thời tiết lạnh 
cold-and-hot test	sự thử nóng-lạnh, sự thử bằng nung nóng-làm lạnh 
collapse load 	tải trọng phá hỏng, tải trọng
collapsible beam 	dầm tháo lắp được 
collar beam 	dầm ngang, xà ngang; thanh giằng (vì kèo) 
combination beam 	dầm tổ hợp, dầm ghép 
combined load 	tải trọng phối hợp 
commercial concrete 	bê tông trộn sẵn 
compession test	sự thử nén 
composit beam 	dầm hợp thể, dầm vật liệu hỗn hợp 
composite load 	tải trọng phức hợp 
compound beam 	dầm hỗn hợp
compound girder 	dầm ghép 
comprehensive test	sự thử toàn diện 
compression reinforcement 	cốt (thép); cốt, sườn 
compressive load 	tải trọng nén 
concentrated load 	tải trọng tập trung 
concrete base course 	cửa sổ tầng hầm
concrete floor 	Sàn bê tông
concrete mixer/gravity mixer 	Máy trộn bê tông
cone test	sự thử nghiệm (độ sụt vữa bê tông) bằng chùy hình nón 
conjugate beam 	dầm trang trí, dầm giả 
connected load 	tải trọng liên kết 
consistency test of concrete	sự thử nghiệm độ sụt của vữa bê tông 
constant load 	tải trọng không đổi, tải trọng tĩnh 
continuity test	sự thử tính liên tục 
continuous beam 	dầm liên tục
continuous concrete 	bê tông liền khối 
continuous girder 	dầm liên tục 
continuous load 	tải trọng liên tục; tải trọng phân bố đều 
contractor's name plate 	Biển ghi tên Nhà thầu
controlling beam 	tia điều khiển 
convergent beam 	chùm hội tụ
copper clad steel	thép mạ đồng
cover ( boards) for the staircase 	Tấm che lồng cầu thang
crane beam 	dầm cần trục 
crane girder 	giá cần trục; giàn cần trục 
crane load 	sức nâng của cần trục, trọng tải của cần trục 
creep test	sự thử độ rão; sự thử độ lưu biến 
creep-rupture test	sự thử độ rão-gãy 
crippling load 	tải trọng phá hủy 
crippling test	sự thử uốn dọc; sự thử uốn đi uốn lại 
critical load 	tải trọng tới hạn 
cross beam 	dầm ngang, xà ngang 
cross girder 	dầm ngang 
crushing load 	tải trọng nghiền, tải trọng nén vỡ 
crushing test	sự thử nén vỡ 
cube strength 	Độ bền nén ba phương
curb girder 	đá vỉa; dầm cạp bờ
cyclic load 	tải trọng tuần hoàn 
cyclopean concrete 	bê tông đá hộc 
damping test	sự thử giảm xóc, sự thử giảm âm; sự thử thấm 
de-aerated concrete 	bê tông (đúc trong) chân không 
dead load 	tĩnh tải 
dead weight load 	tĩnh tải 
deck girder 	giàn cầu 
definitions 	Các định nghĩa
deflection test	sự thử uốn 
deformation test	sự thử biến dạng 
demand load 	tải trọng yêu cầu 
dense concrete 	bê tông nặng
design load 	tải trọng tính toán, tải trọng thiết kế 
destructive test	sự thử phá hủy 
diagnostic test	sự thử chẩn đoán
diagonal reinforcement 	cốt (thép) xiên, cốt (thép) đặt chéo 
direct-acting load 	tải trọng tác động trực tiếp 
discontinuous load 	tải trọng không liên tục 
disposable load 	tải trọng có ích 
distributed load 	tải trọng phân bố 
distributing reinforcement 	cốt (thép) phân bố 
divergent beam 	chùm phân kỳ 
double angle	thép góc ghép thành hình T
double strut trussed beam 	dầm tăng cứng hai trụ chống 
draw beam 	dầm nâng, cần nâng 
drawbar load 	lực kéo ở móc 
drawbar test	sự thử thanh kéo 
drill test	sự thử khoan 
drop test	sự thử va dập; sự thử thả rơi; sự thử sụt điện áp 
drum test	sự thử gõ đập 
dry concrete 	bê tông trộn khô, vữa bê tông cứng 
dummy load 	tải trọng giả 
dummy test	sự thử mô hình; sự thử hình mẫu 
duplicate test	sự thử lặp lại 
dynamic test	sự thử động lực 
dynamic(al) load 	tải trọng động lực học 
early strenght concrete 	bê tông mau cứng 
earthquake test	sự thử sức bền động đất, sự thử sức chịu động đất 
eccentric load 	tải trọng lệch tâm 
effiency test	sự thử công suất, sự thử năng suất; sự thử hiệu suất 
elastic limit load 	tải trọng giới hạn đàn hồi 
elongation test	sự thử kéo dài; sự thử độ kéo dài 
end bearing capacity 	Sức chống mũi
end girder 	dầm gối tường 
endurance test	sự thử độ bền; sự thử sức chịu đựng 
endurance-tension test	sự thử độ bền kéo, sự thử sức chịu kéo 
enduranceưtorsion test	sự thử độ bền xoắn, sự thử sức chịu xoắn 
endưquench test	sự thử độ thấm tôi 
equalizing beam 	đòn cân bằng 
equivalent load 	tải trọng tương đương
even load 	tải trọng đều, tải trọng phân bố đều 
excess concrete 	vữa bê tông phân lớp 
expanded slag concrete 	bê tông xỉ nở 
exposed concrete 	bê tông mặt ngoài(công trình) 
exposure test	sự thử phơi sáng
fabric reinforcement 	cốt (thép) lưới 
face-bend test	sự thử uốn bề mặt (thử mối hàn) 
failing load 	tải trọng phá hủy 
failure-rate test	sự thử tốc độ phá hủy 
fan beam 	chum tia hình quạt 
fascia beam 	dầm có cánh 
fascia girder 	dầm biên 
fatigue test	sự thử độ mỏi
feeder skip 	Thùng tiếp liệu
fence 	bờ rào, tường rào
fender beam 	dầm chắn 
fibrous concrete 	bê tông sợi 
fictitious load 	tải trọng ảo 
field test	sự thử ở hiện trường
fine concrete 	bê tông mịn 
first course 	hàng /lớp gạch đầu tiên
fish-bellied beam 	dầm phình giữa, dầm bụng cá (để có sức bền đều) 
fixed beam 	dầm ngàm hai đầu, dầm cố định 
fixed load 	tải trọng cố định, tải trọng không đổi 
flanged beam 	dầm có bản cánh, dầm có gờ; dầm chữ I 
flat bar	thép dẹt
float 	bàn xoa
floated concrete 	(vữa) bê tông nhão/bê tông chảy lỏng 
floor beam 	dầm sàn 
flow test	sự thử tính lưu động của vật liệu (sơn, vữa...) 
flow test of concete	sự thử độ sụt (hình nón) của vữa bê tông 
fluctuating load 	tải trọng dao động 
fly-ash concrete 	bê tông bụi tro
foam concrete 	bê tông bọt 
foundation girder 	dầm móng 
fracture test	sự thử đứt gãy 
frame girder 	giàn khung 
frame reinforcement 	cốt (thép) giàn 
free beam 	dầm tự do 
free-bend test	sự thử uốn tự do 
free-fall test	sự thử rơi tự do 
freezing test	sự thử đông lạnh; sự thử tính chịu đông lạnh 
fresh concrete 	bê tông mới đổ 
friability test	sự thử độ giòn 
front beam 	dầm trước 
fuel consumption test	sự thử nghiệm tiêu hao nhiên liệu 
full load 	tải trọng toàn phần 
full-scale test	sự thử nguyên cỡ; sự thử mô hình nguyên cỡ 
galvanised steel	thép mạ kẽm
gas concrete 	bê tông xốp 
gate 	Cửa
glass concrete 	bê tông thủy tinh 
glass-reinforced conc. 	bê tông cốt thủy tinh
glavel concrete 	bê tông (cốt liệu) sỏi 
glazed concrete 	bê tông trong 
gradually applied load 	sự chất tải tăng dần 
granolithic concrete 	bê tông granit
grating beam 	dầm ghi lò 
gravity load 	tải trọng bản thân, tự trọng 
green concrete 	bê tông mới đổ 
green test	sự thử chạy rà 
grillage reinforcement 	cốt (thép) lưới sợi 
grinding test	sự thử khả năng gia công bằng mài, sự thử bằng mài 
gross load 	tải trọng tổng, tải trọng toàn phần 
ground floor (hoặc first floor nếu là tiếng Anh Mỹ) 	tầng trệt (tiếng Nam), tầng một (tiếng Bắc)
guard board 	tấm chắn, tấm bảo vệ
gunned concrete 	bê tông phun 
gust load 	(hàng không) tải trọng khi gió giật 
gypsum concrete 	bê tông thạch cao 
half- beam 	dầm nửa 
half-latticed girder 	giàn nửa mắt cáo 
hammer beam 	dầm hẫng, dầm chìa, dầm công xôn 
hanging beam 	dầm treo 
hanging test	sự thử kéo đứt bằng treo 
hard rock concrete 	bê tông (cốt liệu) đá cứng 
hard steel	thép cứng
hardenet concrete 	bê tông đã đông cứng 
hardness test	sự thử độ cứng 
haydite concrete 	bê tông keramit 
head beam 	dầm mũ cọc 
heading bond 	cách xây hàng ngang (gạch xây ngang)
heading course 	hàng, lớp xây ngang
heaped concrete 	bê tông chưa đầm
heat load 	tải trọng do nhiệt 
heat test	sự thử bằng nung nóng 
heat-resistant concrete 	bê tông chịu nhiệt 
heavy concrete 	bê tông nặng 
helical reinforcement 	cốt (thép) xoắn 
hello	xin chào
high beam 	đèn rọi xa, chùm sáng rọi xa 
high slump concrete 	bê tông chảy 
high tensile steel	thép cường độ cao
high yield steel	thép đàn hồi cao
hinged beam 	dầm đòn gánh, dầm quay quanh bản lề ở giữa 
hinged cantilever girder 	dầm đỡ - ghép bản lề 
hinged girder 	dầm ghép bản lề 
hold beam 	dầm khô (dầm tàu ở chỗ khô) 
hollow block wall 	Tường xây bằng gạch lỗ (gạch rỗng)
hollow section	thép hình rỗng
hooped concrete 	bê tông cốt thép vòng 
hose (hosepipe) 	ống nước - Chú thích ở đây là loại ống mềm như dạng ống nhựa dùng để rửa xe ấy
hot rolled steel	thép cán nóng
hot test	sự thử bằng nung nóng 
hot-laid asphaltic conc.	bê tông atphan đúc nóng 
hot-mixed asphaltic conc	bê tông atphan trộn nóng 
hydraulic test	sự thử thủy lực 
hydrostatic test	sự thử thủy tĩnh 
impact bend test	sự thử uốn va đập 
impact compression test	sự thử nén va đập 
impact endurance test	sự thử độ bền va đập 
impact hardness test	sự thử độ cứng va đập 
impact load 	tải trọng va đập 
impact test	sự thử va đập, sự thử dát 
imposed load 	tải trọng đặt vào 
impulse test	sự thử bằng xung 
impulsive load 	tải trọng va đập, tải trọng xung 
in-situ material test	sự thử nghiệm vật liệu tại hiện trường 
incompletely compacted c	bê tông đầm chưa đủ
increment load 	tải trọng phụ 
independent girder 	dầm phụ, dầm rồi 
indivisible load 	tải trọng không chia nhỏ được 
inductive load 	tải trọng cảm ứng 
initial load 	tải trọng ban đầu 
instantaneous load 	tải trọng tức thời 
insulating concrete 	bê tông cách nhiệt 
intermittent load 	tải trọng gián đoạn 
intrinsic fatigue-limit test	sự thử giới hạn mỏi nội tại
ion beam 	chùm ion 
irregularly distributed load	tải trọng phân bố không đều 
isteg reinforcement 	cốt (thép) có gờ 
jamb 	Đố dọc cửa, thanh đứng khuôn cửa
job-placed concrete 	bê tông đổ tại chỗ 
joggle beam 	dầm ghép mộng 
joint beam 	thanh giằng, thanh liên kết 
junior beam 	dầm bản nhẹ 
king post girder 	dầm tăng cứng một trụ 
laboratory simulation test	sự thử bằng phương pháp mô phỏng trong phòng thí nghiệm 
laboratory test	sự thử trong phòng thí nghiệm 
ladder 	cái thang
laminated beam 	dầm thanh 
landing beam 	chùm sáng dẫn hướng hạ cánh 
laser beam 	chùm tia laze 
lateral load 	tải trọng ngang 
lateral reinforcement 	cốt (thép) ngang 
latrine 	nhà vệ sinh
lattice beam 	dầm lưới, dầm mắt cáo 
lattice girder 	giàn mắt cáo 
laying - on - trowel 	bàn san vữa
leak (age) test	sự thử độ rò 
lean concrete 	bê tông nghèo, bê tông chất lượng thấp 
ledger 	thanh ngang, gióng ngang (ở giàn giáo)
life test	sự thử tuổi thọ, sự thử thời gian sử dụng 
lifting beam 	dầm nâng tải 
light beam 	chùm tia sáng 
light load 	tải trọng nhẹ 
light-weight concrete 	bê tông nhẹ 
lime concrete 	bê tông vôi 
limit load 	tải trọng giới hạn 
linearly varying load 	tải trọng biến đổi tuyến tính 
lintel (window head) 	Lanh tô cửa sổ
liquid concrete 	bê tông lỏng 
live load 	tải trọng động; hoạt tải 
live test	sự thử nghiệm có người (trong khoang tàu thí nghiệm) 
load due to own weight 	tải trọng do khối lượng bản thân; 
load due to wind 	tải trọng do gió; 
load in bulk 	chất thành đống; 
load on axle 	tải trọng lên trục; 
load out 	giảm tải, dỡ tải; 
load per unit length 	tải trọng trên một đơn vị chiều dài 
load test	sự thử có tải trọng 
load up 	chất tải 
loading test	sự thử bằng tải trọng 
long-duration test	sự thử dài hạn, sự thử thời gian sử dụng dài 
long-run test	sự thử vận hành dài hạn, sự thử vận hành lâu, sự thử làm việc lâu 
longitudinal beam 	dầm dọc, xà dọc 
longitudinal girder 	dầm dọc, xà dọc 
longitudinal reinforcement 	cốt (thép) dọc 
loosely spread concrete 	bê tông chưa đầm, bê tông đổ dối 
low slump concrete 	vữa bê tông có độ sụt hình nón thấp, vữa bê tông khô 
lump load 	sự chất tải đã kết tảng; tải vón cục; tải trọng tập trung 
machinability test	sự thử khả năng máy 
machine-placed concrete 	bê tông đổ bằng máy
machining test	sự thử tính gia công trên máy 
main beam 	dầm chính; chùm (tia) chính 
main girder 	dầm chính, dầm cái; xà chính, xà cái 
mallet 	Cái vồ (thợ nề)
masonry bonds 	Các cách xây
mass concrete 	bê tông liền khối, bê tông không cốt thép 
matched load 	tải trọng được thích ứng 
matured concrete 	bê tông đã cứng 
mesh reinforcement 	cốt (thép) lưới 
middle girder 	dầm giữa, xà giữa 
midship beam 	dầm giữa tàu 
minor load 	tải trọng sơ bộ (trong máy thử độ cứng) 
miscellaneous load 	tải trọng hỗn hợp 
mixer operator 	công nhân đứng máy trộn vữa bê tông
mixing drum 	Trống trộn bê tông
mobile load 	tải trọng di động 
model test	sự thử trên mô hình 
momentary load 	tải trọng trong thời gian ngắn, tải trọng tạm thời
monitoring test	sự thử kiểm tra 
monolayer reinforcement 	cốt (thép) một lớp 
monolithic concrete 	bê tông liền khối 
mortar 	vữa
mortar pan (mortar trough, mortar tub) 	thùng vữa
most efficient load 	công suất khi hiệu suất lớn nhất (tuabin) 
motar trough 	Chậu vữa
movable load 	tải trọng di động 
movable rest beam 	dầm có gối tựa di động 
moving load 	tải trọng động 
multilayer reinforcement 	cốt (thép) nhiều lớp 
multispan beam 	dầm nhiều nhịp 
nailable concrete 	bê tông đóng đinh được 
natural condition test	sự thử trong điều kiện tự nhiên 
needle beam 	dầm kim
negative moment reinforcement	cốt (thép) chịu mômen âm 
net load 	tải trọng có ích, trọng lượng có ích 
no-slump concrete 	bê tông cứng (bê tông có độ sụt=0) 
nodulation test	sự thử khả năng hình thành nốt sần 
nomal load 	tải trọng bình thường 
non reactive load 	tải trọng không gây phản lực, tải thuần trở (điện) 
non-central load 	tải trọng lệch tâm 
non-fines concrete 	bê tông hạt thô
non-uniform beam 	dầm tiết diện không đều 
notched bar bending test	sự thử uốn mẫu bị cắt 
notched bar test	sự thử mẫu bị cắt 
oblique angled load 	tải trọng xiên, tải trọng lệch 
off-form concrete 	bê tông trong ván khuôn
online test	sự thử trên đường dây 
operating load 	tải trọng làm việc 
operation test	sự thử trong vận hành, sự thử trong thao tác, sự thử trong điều kiện sử dụng 
optimum load 	tải trọng tối ưu 
oscillating beam 	đòn dao động, đòn lắc 
oscillating load 	tải (trọng) dao động 
outside cellar steps 	cửa sổ buồng công trình phụ
overall factor of safety 	Hệ số an toàn tổng thể
overload test	sự thử quá tải 
oxidation test	sự thử oxi hóa 
panel girder 	dầm tấm, dầm panen 
parabolic girder 	dầm dạng parabôn 
parallel girder 	dầm song song 
partial load 	tải trọng từng phần 
pay(ing) load 	tải trọng có ích 
peak load 	tải trọng cao điểm 
penetration test	sự thử độ thấm; sự thử độ xuyên (hàn) 
percussion test	sự thử va đập 
perfomance test	sự thử vận hành 
perfume concrete 	tinh dầu hương liệu 
periodic load 	tải trọng tuần hoàn 
permanent load 	tải trọng không đổi; tải trọng thường xuyên 
permeable concrete 	bê tông không thấm 
permissible load 	tải trọng cho phép 
phantom load 	tải trọng giả 
pile shaft area 	Diện tích xung quanh cọc
plain bar	thép trơn
plain concrete 	bê tông không cốt thép, bê tông thường 
plain girder 	dầm khối 
plane girder 	dầm phẳng 
plank platform (board platform) 	sàn lát ván
plaster concrete 	bê tông thạch cao 
plastic concrete 	bê tông dẻo
plate girder 	dầm phẳng, dầm tấm 
plate load 	tải anôt 
plate steel	thép bản
platform railing 	lan can/tay vịn sàn (bảo hộ lao động)
plumb bob (plummet) 	dây dọi, quả dọi (bằng chì)
point load 	tải trọng tập trung 
pony girder 	dầm phụ 
poor concrete 	bê tông nghèo, bê tông gày 
portland cement concrete	bê tông xi măng pooclan 
post stressed reinforcement 	cốt (thép) ứng lực sau 
post-stressed concrete 	bê tông ứng lực sau 
post-tensioned concrete 	bê tông ứng lực sau 
pre-operational test	sự thử trước vận hành 
pre-production test	sự thử trước sản xuất, sự thử trước khi đưa vào sản xuất 
pre-stressed reinforcement 	cốt (thép) ứng lực trước 
precast concrete 	bê tông đúc sẵn 
prefabricated concrete 	bê tông đúc sẵn 
preliminary test	sự thử sơ bộ 
prepact concrete 	bê tông đúc từng khối riêng 
pressure load 	tải trọng nén 
prestressed concrete 	bê tông ứng lực trước 
prestressed girder 	dầm dự ứng lực 
printing beam 	(máy tính) chùm tia in 
production test	sự thử trong sản xuất; sự thử tại nhà máy 
proof load 	tải trọng thử 
pulling test	sự thử kéo 
pulsating load 	tải trọng mạch động 
pumice concrete 	bê tông đá bọt 
pump concrete 	bê tông bơm 
punching test	sự thử đột lỗ 
putlog (putlock) 	thanh giàn giáo, thanh gióng
quaking concrete 	bê tông dẻo 
quality concrete 	bê tông chất lượng cao 
quenching test	sự thử bằng cách tôi; mẫu thử độ thấm tôi
quick test	sự thử nhanh 
quiescent load 	tải trọng tĩnh 
racking (raking) back 	đầu chờ xây
racking load 	tải trọng dao động 
radial load 	tải trọng hướng kính 
radio (-frequency) beam 	chùm tần số vô tuyến điện 
rammed concrete 	bê tông đầm 
rapid test	sự thử nhanh 
rated load 	tải trọng danh nghĩa 
reactivity test	sự thử hoạt tính 
ready-mixed concrete 	bê tông trộn sẵn
reasonableness test	sự kiểm tra tính hợp lý 
reception test	sự thử nghiểm thu 
refractory concrete 	bê tông chịu nhiệt 
reinforced concrete 	bê tông cốt thép 
reinforced concrete beam 	dầm bê tông cốt thép 
reinforced concrete lintel 	Lanh tô bê tông cốt thép
relaxation test	sự thí nghiệm tính chùng (của vật liệu) 
removable gate 	Cửa tháo rời được
repeated load test	sự thử bằng tải trọng lặp lại 
resistive load 	tải thuần trở, tải ômic 
resonance test	sự thử bằng cộng hưởng 
resonant fatigue test	sự thử độ mỏi bằng cộng hưởng 
restrained beam 	dầm ngàm hai đầu 
retempered concrete 	bê tông trộn lại 
reversal load 	tải trọng đổi dấu 
rich concrete 	bê tông giàu, bê tông chất lượng cao 
ridge beam 	đòn nóc 
rigid reinforcement 	cốt (thép) cứng 
riveted girder 	dầm ghép tán đinh 
rod test	sự thử bằng thanh thăm dò 
rolled steel	thép cán
roof beam 	dầm mái 
round hollow section	thép hình tròn rỗng
routine test	sự thử theo thủ tục; sự thử thường xuyên
rubbed concrete 	bê tông mài mặt 
rubble concrete 	bê tông đá hộc 
running-in test	sự thử chạy rà 
rupture test	sự thử đứt gãy 
rush-hour load 	tải trọng trong giờ cao điểm 
safe load 	tải trọng an toàn, tải trọng cho phép 
sample test	sự thử chọn mẫu (để xác định phần trăm chính phẩm)
sand-blasted concrete 	bê tôngmài bóng bề mặt
scaffold pole (scaffold standard)	cọc giàn giáo
scaffolding joint with chain (lashing, whip, bond)	mối nối giàn giáo bằng xích (dây chằng buộc, dây cáp)
scale beam 	đòn cân 
scale model test	sự thử mô hình đồng dạng, sự thử mẫu đồng dạng 
scanning beam 	chùm tia quét 
scattered beam 	chùm tán xạ 
scleroscope hardness test	sự thử độ cứng kiểu xung 
scratch hardness test	sự thử độ cứng kiểu vạch 
screen test	sự kiểm tra bằng sàng 
secondary beam 	dầm trung gian 
secondary girder 	dầm phụ 
segmental girder 	dầm cánh biên trên cong 
segregating concrete 	vữa bê tông phân lớp 
semi-destructive test	sự thử bán hủy 
semi-fixed girder 	dầm cố định một đầu 
sensitivity test	sự thử tính nhạy cảm; sự thử độ mẫn cảm 
service load 	tải trọng sử dụng, tải trọng có ích 
service test	sự thử vận hành; sự thử khai thác sử dụng 
setting load 	tải trọng khi lắp ráp 
shaft frictional capacity 	Ma sát xung quanh cọc
shallow beam 	dầm thấp 
shatter test	sự thử đập vỡ 
shear load 	lực cắt 
shearing test	sự thử bằng cách cắt 
shock load 	tải trọng va chạm 
shock test	sự thử va đập 
short-circuit test	sự thử ngắn mạch 
shutter 	cốp pha 
signboard (billboard) 	Bảng báo hiệu
silicon steel	thép silic
simulation test	sự thử bằng phương pháp mô phỏng 
single non central load 	tải trọng tập trung không đúng tâm 
single test	sự thử đơn chiếc, sự thử từng cái 
site fence 	tường rào công trường
site hut (site office ) 	Lán (công trường)
slag concrete 	bê tông xỉ 
slender beam 	dầm mảnh
sludge test	sự xác định hàm lượng cặn 
slump test	sự thử nghiệm độ sụt của vữa bê tông 
small girder 	dầm con; xà con 
snow load 	tải trọng (do) tuyết 
socle beam 	dầm hẫng; dầm công xôn 
socle girder 	dầm công xôn 
soil bearing test	sự thử khả năng chịu tải của đất
soil test	sự thử đất trồng 
solid web girder 	dầm khối 
solubility test	sự thử độ hòa tan
specified rated load 	tải trọng danh nghĩa 
specimen test	sự thử vật mẫu 
spirit level 	ống ni vô của thợ xây
split beam 	dầm ghép, dầm tổ hợp 
sprayed concrete 	bê tông phun 
spring beam 	dầm đàn hồi 
square hollow section	thép hình vuông rỗng
stack of bricks 	đống gạch, chồng gạch
stacked shutter boards (lining boards)	Đống van gỗ cốp pha, chồng ván gỗ cốp pha
stainless steel	thép không gỉ
stamped concrete 	bê tông đầm 
standard brick 	gạch tiêu chuẩn
static hardness test	sự thử độ cứng tĩnh 
static load 	tĩnh tải 
static test	sự thử tĩnh; sự thử bằng tải trọng tĩnh 
static torsion test	sự thử độ xoắn tĩnh 
steady load 	tải trọng ổn định 
steadyưload test	sự thử bằng tải trọng không đổi
steamed concrete 	bê tông đã bốc hơi nước 
steamưpressure test	sự thử bằng áp lực hơi nước 
steel	thép
steel concrete 	bê tông cốt thép 
stiff concrete 	vữa bê tông cứng, vữa bê tông đặc 
stiff reinforcement 	cốt (thép) cứng 
stiffening girder 	dầm cứng 
stone concrete 	bê tông đá dăm 
straining beam 	thanh giằng, thanh kéo 
strength test	sự thử độ bền 
stretching bond 	cách xây hàng dài (gạch xây dọc)
stretching course 	hàng, lớp xây dọc
structral hollow section	thép hình rỗng làm kết cấu
structural section	thép hình xây dựng
structural test	sự thử cấu trúc 
strutting beam 	dầm ngang, xà ngang; thanh giằng (vì kèo) 
sudden load 	tải trọng đột ngột, sự chất tải đột ngột, sự chất tải đột biến 
suddenly applied load 	tải trọng tác dụng đột biến 
sum of skin friction 	Tổng ma sát (vỏ)
superimposed load 	tải trọng phụ thêm 
supersonic test	sự thử bằng siêu âm 
supporting beam 	dầm đỡ, xà đỡ 
surcharge load 	sự quá tải 
surface load 	tải trọng bề mặt 
suspension girder 	dầm treo 
sustained load 	tải trọng tác động lâu dài 
symmetrical load 	tải trọng đối xứng, sự chất tải đối xứng 
tail load 	tải trọng lên đuôi (máy bay) 
tamped concrete 	bê tông đầm 
tangetial load 	tải trọng tiếp tuyến 
tar concrete 	bê tông nhựa đường 
tee girder 	dầm chữ T 
tenacity test	sự thử độ dai; sự thử độ bền đứt 
tensile load 	tải trọng kéo đứt 
tensile test	sự thử sức căng; sự thử kéo 
tension reinforcement 	cốt (thép) chịu kéo 
tension test	sự thử sức căng; sự thử kéo 
terminating load 	tải trọng đặt ở đầu mút (dầm) 
test load 	tải trọng thử 
thermal test	sự thử bằng nhiệt 
thick lead pencil 	bút chì đầu đậm (dùng để đánh dấu)
through beam 	dầm liên tục, dầm suốt 
thrust reinforcement 	cốt (thép) chống cắt 
tilting load 	tải trọng lật đổ 
tool steel	thép công cụ
top beam 	dầm sàn; dầm đỉnh 
torque load 	tải trọng xoắn 
torsion test	sự thử xoắn 
total load 	tải trọng toàn phần, tải trọng tổng 
toughness test	sự thử độ dai (va đập) 
traction load 	tải trọng kéo 
traction test	sự thử sức kéo 
traffic load 	tải trọng chuyên chở 
transient load 	tải trọng ngắn hạn, tải trọng nhất thời 
transit-mix concrete 	bê tông trộn trên xe 
transonic test	sự thử bằng xuyên âm 
transverse beam 	dầm ngang, đà ngang 
transverse test	sự thử uốn ngang 
transversely loaded beam 	dầm chịu tải trọng ngang 
trass concrete 	bê tông puzolan 
trellis girder 	giàn mắt cáo 
tremie concrete 	bê tông đổ dưới nước 
trial load 	tải trọng thử 
trial test	phép thử sơ bộ 
trough girder 	dầm chữ U, dầm lòng máng 
trowel 	cái bay thợ nề
trussed beam 	dầm giàn, dầm mắt cáo 
trussed girder 	dầm vượt suốt; giàn vượt suốt 
tubular girder 	dầm ống 
tuned plate load 	tải điều hướng (trong mạch anôt) 
twisting test	sự thử xoắn
two-way reinforcement 	cốt (thép) hai hướng
ultimate load 	tải trọng giới hạn 
ultrasonic test	sự thử bằng siêu âm 
unbalanced load 	tải trọng không cân bằng 
uniform beam 	dầm tiết diện không đổi, dầm (có) mặt cắt đều 
uniform load 	tải trọng đều 
unit load 	tải trọng riêng, tải trọng trên đơn vị diện tích 
up load 	tải trọng thẳng đứng lên trên (lực nâng) 
upper floor	Tầng trên
upsetting test	sự thử co, sự thử chồn 
useful load 	tải trọng có ích 
utility room door	cửa buồng công trình phụ
utility room window 	cửa sổ buồng công trình phụ
vacuum concrete 	bê tông chân không 
variable load 	tải trọng biến đổi 
varying load 	tải trọng biến đổi 
vibrated concrete 	bê tông đầm rung 
vibration test	sự thử độ rung 
wall beam 	dầm tường 
warranty test	sự thử nghiệm thu 
water cured concrete 	bê tông dưỡng hộ trong nước 
water test	sự thử thủy lực 
wearing test 	sự thử mài mòn 
web girder 	giàn lưới thép, dầm đặc
weldability test	sự thử tính hàn 
welding test	sự thử bằng hàn 
wet concrete 	vữa bê tông dẻo 
wheel load 	áp lực lên bánh xe 
wheelbarrow 	Xe cút kít, xe đẩy tay
whole beam 	dầm gỗ 
wind beam 	xà chống gió 
wind load 	tải trọng (do) gió 
window ledge 	Ngưỡng (bậu) cửa sổ 
wooden beam 	xà gồ, dầm gỗ 
work platform (working platform) 	Bục kê để xây
workable concrete 	bê tông dễ đổ 
working beam 	đòn cân bằng; xà vồ (để đập quặng) 
working load 	tải trọng làm việc
writing beam 	tia viết 
zonolite concrete 	bê tông zônôlit (bê tông ko thấm nước)
﻿Abraham’s cones	Khuôn hình chóp cụt để đo độ sụt bê tông
